OOOOOOOOOO
O#b      %
O#XXPX  g%
O#%#    g%
O#C  ###g%
O#  C %mg%
O# Cp OOg%
O#E   OOg%
O###    g%
OOOOOOOOOO
