OOO#####O#
Ot% m    #
OOOXC   C#
#       g#
#       g#
#  C   #g#
#  O   #C#
#    PO# #
#b# pt #E#
####O#####
