#OO#OO#OO#
Ob      %O
OXXPX  g%O
#%#    g%#
OC  ###g%O
O  C %mg%O
# Cp OOg%#
OE   OOg%O
O##    g%O
#OO#OO#OO#
