OOO#####O#
Ot% X   X#
OOO     g#
#   C   g#
#       g#
#  C   #g#
#  O   #C#
#    PO# #
#b#Xpt #E#
####O#####
