##########
##t     E#
##P#  ####
# g   p X#
#Pg   X %#
#Og   C C#
##g  #% b#
OCg #m####
O g OgggtO
#OO#######
