##########
#        #
#  gggg  #
#  g     #
#  g     #
#  ggg   #
#  g     #
#  g     #
#        #
##########
